1111111111111111111111111111111111111111111111111111111111111
1000000000000000000000000000000000000000000100000000000000001
1010V0000F001000000000000V00000000000000000000000000000001001
1000100000000000000000000000000000000000000100000000E00000001
1000000000111000000000111011000000111111111000000000000000001
11111001111111111111110000000000000000V0000000000000000000001
11111001000000V0000000000000100000111111111111100000000000001
1000000000011111111111000000100000111111111111110000000000001
11111000000111111111110000001000001111111111111100000V0000001
1111100111111111111111000000000000111111111111110000000000001
1111100111111111111111000000000000000000000000010100000000001
1000000011111111111111000000111111000000000000100010000000001
1000000000000000111111000000111111111000000000100010000000001
1000000000000000111111000000111111111111100000010110000000001
1000000000000000111111000000111111111111110000000011000000011
1000000000000000111111000000111111111111100000000111000000111
100000000000000000B0000000000C0000000000000000000111111111001
100000000000000000000P000000000000000000000000000100000000001
1111111111111111111111111111111111111111111111111111111111111
