111111
1E0PC1
10C001
1T0P01
111111