111111
1E00C1
10C0A0
1T00P1
111111