11111111111111
100TC000000101
1000P000T00101
1T0000E00000C1
1000T0000C0001
11111111111111
