11111111111111
100TC0000001C1
1000P000T00101
1T0000E0000001
1000T000000001
11111111111111