111111111111111111111111111111
100000000000000000000000000001
110000010000000000000000000001
100010000000000000000111100001
10000001E000C00000000000000001
111011100000000000000000000001
101010000000000000000000100001
100001000000000001000000100001
100001000100000010000011100001
100001000100000110000100000001
100001000011001000000100111111
100001000001001000000101000001
100000111111001000000101100001
10000G0000000P0000000000010001
100000000000000000000000010001
111111111111111111111111111111